..##..##..
...##...#.
.#.....#..
####.....@
...#..#...
#....#....
###....##.
.....#.#..
##...#....
.#....#.##
