##...#.##.
....###...
##...#...#
...@...###
##...##...
#...#...##
..#....###
...##.##..
#........#
###...##..
