..........
..#....#..
..#....#..
..#....#..
..........
.#......#.
..#....#..
...####...
..........
@.........
